NO ./textures/Nord.xpm
SO ./textures/Sud.xpm
WE ./textures/Ouest.xpm
EA ./textures/Est.xpm
F 117,117,117
C 0,28,255
11111
1S001
11N11
10001
11111
