NO ./textures/metal1.xpm
SO ./textures/metal2.xpm
WE ./textures/metal3.xpm
EA ./textures/metal4.xpm
F 98, 15, 176
C 176, 15, 98
111111111111111111111111111111111111111111111111
111111111111000000000000000000000000000000000001
1S1000111111011111111111111010111111111111111111
101010111111010000000000011010000000000000000001
100010000001011111111111111011111111111111111101
110111111101000000000000011000000000000000000101
100000000001111111111111011111111111111111110101
100011111110000000010001011000000000000000000101
101111111110111111011011011011111111111111111101
101000000000100001000011011011111111111111111101
101011111111111011101111011010000000000000000001
100011111110000000000001011010111111111111111111
111111111110111111111111011010000000000000000001
111111111110111111111111011011111111111111111101
111111111110000000000000011000000000000000000001
111111111111111111111111111111111111111111111111
