NO ./textures/brick1.xpm
SO ./textures/brick2.xpm
WE ./textures/brick3.xpm
EA ./textures/brick4.xpm
DO ./textures/door0.xpm
D1 ./textures/door1.xpm
D2 ./textures/door2.xpm
D3 ./textures/door3.xpm
F 175,175,122
C 2,28,255
1111111111111111111111111111111111111111111111111111111111111111111111
1111111111112222222111222212211222111111112111112112111111111111111111
1111111111112112112111211212121211111111112111112222111111111111111111
1111111111112112112111211212121222111111112222211112111111111111111111
1111111111112112112111222212121211111111112111211112111111111111111111
1111111111112112112111211212211222111111112222211112111111111111111111
1111111111112222222222222222222222222222222222221111111111111111111111
1S12221111112111111111111112121111111111111111121111111111111111111111
1212121111112122222222222112122222222222222222121111111222222221111111
1222122222212111111111111112111111111111111111121111111211111121111111
1121111111212222222222222112222222222222222222121111111211111121111111
1121111111212222222222222112222222222222222222121111111222222221111111
1222222222211111111111112111111111111111111122121111111211111121111111
1222111111122222222122212112222222222222222222121111111211111121111111
1222111111121222212122212112222222222222222222121111111211111121111111
1211111111121111112112112112211111111111111111121111111111111111111111
1212222222221222212222112112211111111111111111121111111111121111111111
1212111111111112111211112112212222222222222222221111111111121111111111
1222111111122222222222212112212111111111111111111111111122222221111111
1111111111121111111111112112212222222222222222221111111111121111111111
1111111111121111111111112112211111111111111111121111111111121111111111
1111111111122222222222222112212222222222222222221111111111121111111111
1111111111122222222222222112222222222222222222221111122222221111111111
1111111111111111111111111111111111111111111111111111111111111111111111
